3 0 0 0 0 0 0 0 0 0 0 0 0 0 0 0 0 0 0 0 0 0 0 1
3 5 5 11 12 13 17 18 49 76 77 70 70 71 72 73 70 70 82 82 70 132 70 1
3 7 8 14 15 16 19 20 50 78 79 80 69 74 15 75 69 69 83 83 69 133 69 1
3 9 10 0 0 0 136 137 3 0 0 81 0 0 0 0 0 0 84 85 0 0 0 1
3 0 0 21 22 23 0 0 3 29 0 0 0 0 0 0 0 0 0 0 0 0 67 1
3 0 0 24 25 26 0 0 0 0 0 0 0 64 59 59 59 64 0 0 0 68 66 1
3 0 0 0 0 0 0 0 0 0 0 0 38 58 59 62 59 61 0 0 0 0 65 1
3 0 0 0 0 0 0 0 3 55 0 0 39 57 59 63 59 60 0 0 0 0 65 1
3 27 0 0 0 0 0 29 3 56 0 0 40 0 0 0 0 0 0 0 0 0 27 1
3 28 0 0 0 0 30 31 3 54 0 0 0 0 0 0 0 0 0 0 0 0 28 1
3 34 0 0 0 29 32 33 3 53 0 29 51 0 0 0 0 0 0 52 52 52 34 1
3 35 0 0 49 126 126 126 126 126 126 126 0 0 0 0 0 0 0 70 70 70 6 1
3 36 0 0 50 122 134 135 123 124 125 46 0 0 0 0 0 0 0 130 129 69 127 1
3 37 0 0 3 110 111 112 113 114 115 4 0 0 116 117 118 0 0 119 120 0 121 1
3 0 0 0 3 4 109 108 4 4 4 4 0 68 106 105 104 103 0 21 99 23 98 1
3 38 41 42 48 4 4 4 4 4 4 4 0 0 102 101 100 0 0 24 97 26 96 1
3 39 43 44 47 92 93 4 4 4 4 4 1 0 0 0 0 0 0 64 64 27 95 1
3 40 0 45 3 86 87 88 89 90 4 91 1 64 0 0 0 0 0 0 0 34 0 1
3 2 2 2 2 2 2 2 2 2 2 2 2 2 2 2 2 2 2 2 2 2 2 1

