2 9 11 12 9 4 4 15 4 16 17 18 4 15 4 4 47 46 4 4 4 4 4 4 4 4 4 4 4 4 19 19 19 4 4 4 4 4 4 4  
2 29 13 14 29 0 5 0 0 0 0 0 0 0 0 0 45 45 0 0 0 0 5 6 6 6 6 6 6 6 6 6 6 6 6 6 6 6 6 1  
2 0 0 0 0 0 5 0 0 0 0 0 0 30 30 30 0 0 0 30 30 0 5 6 8 8 8 8 8 8 8 8 8 8 8 8 8 8 6 1  
2 0 0 30 0 0 30 0 0 30 0 0 0 0 0 30 30 0 30 0 30 0 5 6 6 8 8 8 8 8 7 7 7 7 7 7 8 8 6 1  
41 39 0 0 0 0 0 0 0 30 30 0 0 0 5 0 0 0 0 0 0 30 5 7 52 7 7 7 8 8 7 8 8 7 53 7 8 8 6 1  
42 40 0 0 0 0 0 0 0 0 31 30 0 0 5 0 0 31 30 30 0 0 5 7 6 8 8 7 7 7 7 8 8 7 7 7 8 8 6 1  
2 0 0 0 0 0 0 5 0 0 31 0 30 30 5 0 0 0 0 30 0 0 5 7 6 8 8 8 8 8 8 8 8 8 8 8 8 8 6 1  
2 0 0 0 0 0 0 5 0 0 0 0 30 0 5 0 0 0 0 0 0 0 5 7 6 6 6 6 6 6 6 6 6 6 6 6 6 6 6 1  
2 4 43 4 4 4 4 4 4 4 0 0 0 0 4 4 4 4 4 4 4 4 5 0 0 0 0 0 0 0 0 0 0 0 0 0 0 0 0 1  
2 4 44 4 4 4 4 4 4 9 0 0 0 0 9 4 4 4 4 4 4 48 5 0 31 0 0 0 0 0 0 0 0 0 30 30 0 0 0 1  
2 0 0 0 5 20 0 0 0 29 0 0 0 0 29 0 0 0 0 0 0 0 5 4 4 49 4 4 4 4 5 0 0 0 0 5 4 4 4 1  
2 0 0 0 5 0 0 0 0 0 0 0 0 0 0 31 0 0 31 0 30 0 5 10 10 10 50 50 10 10 5 0 0 0 0 5 51 4 4 1  
2 0 0 0 5 0 0 0 0 0 2 0 0 31 31 0 0 0 0 0 0 30 30 0 0 0 45 45 0 0 5 0 31 0 0 5 0 0 54 1  
2 0 0 0 5 0 0 0 0 0 2 0 31 0 0 0 0 30 0 0 0 30 30 30 30 30 0 0 0 0 5 0 0 0 0 5 0 0 0 1  
2 21 0 0 5 0 0 0 0 0 2 0 0 0 0 0 30 0 0 0 0 30 0 0 0 0 31 0 0 0 2 0 31 0 0 5 0 0 0 1  
2 0 0 0 5 0 0 0 0 0 2 54 0 0 0 0 0 0 0 0 0 0 5 0 0 0 0 30 30 0 2 0 0 0 0 5 0 30 0 1  
2 0 0 0 5 4 4 0 0 4 4 4 4 4 4 4 4 4 4 4 4 4 5 0 0 31 31 0 0 30 2 0 0 0 21 5 0 30 0 1  
2 0 0 0 5 4 9 0 0 9 4 4 4 46 4 4 4 4 4 4 4 28 5 0 0 0 5 0 0 0 2 0 0 0 0 5 0 30 30 1  
2 0 0 0 0 0 29 0 0 29 0 0 5 45 0 0 0 0 0 0 0 0 5 0 0 0 2 0 30 0 2 0 0 0 0 5 0 0 0 1  
2 0 0 31 0 0 0 0 0 0 0 0 5 0 0 0 0 0 1 4 4 4 5 0 0 30 2 0 0 30 5 0 0 0 0 5 0 0 0 1  
2 4 4 4 4 4 4 4 4 4 4 43 5 0 0 30 30 0 1 46 4 4 5 0 30 0 2 0 0 0 9 0 0 0 0 9 0 0 0 1  
2 48 4 4 4 4 4 4 4 4 4 44 5 0 0 30 0 0 1 45 0 0 30 30 0 0 2 0 0 0 29 0 30 0 0 29 0 0 0 1  
2 0 0 30 0 0 0 0 0 0 0 0 5 0 0 0 0 0 0 0 30 30 30 0 0 0 2 0 0 0 0 0 31 30 0 0 0 0 0 1  
2 0 31 30 30 30 0 0 0 0 0 0 5 0 0 30 30 0 0 31 0 30 30 0 0 0 2 0 0 0 4 4 4 4 4 4 0 57 59 1  
2 0 31 30 0 5 0 0 31 0 30 30 0 30 30 30 31 0 1 0 0 0 0 30 30 0 5 0 0 0 5 27 23 24 27 5 0 55 56 1  
2 0 0 0 0 2 0 31 31 0 30 0 0 0 30 30 0 0 1 0 0 0 21 0 0 0 5 0 0 0 5 44 25 26 44 5 0 57 59 1  
2 0 30 0 0 2 0 0 30 30 0 0 49 0 0 0 0 0 1 0 30 0 0 0 0 0 5 0 0 0 30 30 0 0 30 0 0 55 56 1
2 0 0 0 0 5 0 0 0 0 0 0 5 0 0 31 31 0 1 0 0 30 30 0 0 54 5 0 0 30 30 30 0 0 0 0 0 57 59 1  
2 32 33 3 3 3 3 3 3 3 3 3 3 3 3 3 3 3 3 3 3 3 3 3 3 3 3 3 3 3 3 3 3 3 3 3 3 58 60 1
2 3 3 3 3 3 3 3 3 3 3 3 3 3 3 3 3 3 3 3 3 3 3 3 3 3 3 3 3 3 3 3 3 3 3 3 3 3 3 1  
